**********
*P       *
*        *
*        *
*    M   *
****     *
*        *
*    *****
*       G*
**********
